                   +---------------+
                   |...............|
                   |...............|
                   |...............|
                   |...............|
        +----------+---------------+
        |..........|...............|
        |..........|...............|
        |..........|...............|
        |..........|...............|
        |..........|...............|
        |..........|...............|
        |..........|.............v.|
        |..........|.......@.......|
        +----------+---------------+$