                   +---------------+
                   |...............|
                   |...............|
                   |...............|
                   |.......^.......|
        +----------+---------------+
        |..........|...............|
        |..........|...............|
        |..........|...............|
        |..........|...............|
        |..........|...............|
        |..........|.......@.......|
        +----------+---------------+$