                   +---------------+
                   |...............|
                   |...............|
                   |...............|
                   |...............|
        +----------+---------------+
        |..........|...............|
        |..........|...............|
        |..........|...............|
        |.........<|...............|
        |..........|...............|
        |..........|...............|
        |..........|...............|
        |..........|.......@.......|
        +----------+---------------+$