        +----+
        |....|
+-------+....|
|@...........+--+
+---+..++.......|
    +--++-----.-+
    |...........+--------+
    |....................|
    |....................|
    |....................|
    |....................|
    |...................E|
    +--------------------+